#############################################
#          #                     #          #
# ### #### # #### ### # ### #### # #### ### #
# ### #### # #### ### # ### #### # #### ### #
#                                           #
# ### # ####### # ### # ### # ####### # ### #
#     #    #    #     #     #    #   \#     #
##### #### # #### ######### #### # #### #####
#   # #         # #   #   # #         # #   #
##### # ### ### # ######### # ### ### # #####
#       # = = #               # = = #       #
##### # ####### # ######### # ####### # #####
#   # #         # #   #   # #         # #   #
##### # ####### # ######### # ####### # #####
#          #                     #          #
# ### #### # #### ### # ### #### # #### ### #
#   #             #   #   #             #   #
### # # ####### # # ##### # # ####### # # ###
#     #    #    #     #     #    #    #     #
# ######## # ######## # ######## # ######## #
#         %                                 #
##### ########### ######### ########### #####
#          #          #          #          #
# ### #### # #### ### # ### #### # #### ### #
# ### #### # #### ### # ### #### # #### ### #
#                                           #
# ### # ####### # ### # ### # ####### # ### #
#     #    #    #     #     #    #    #     #
##### #### # #### ######### #### # #### #####
#   # #         # #   #   # #         # #   #
##### # ### ### # ######### # ### ### # #####
#       #     #               #     #       #
##### # ####### # ######### # ####### # #####
#   # #         # #   #   # #         # #   #
##### # ####### # ######### # ####### # #####
#         .#                     #          #
# ### #### # #### ### # ### #### # #### ### #
#   #             #   #   #             #   #
### # # ####### # # ##### # # ####### # # ###
#     #    #    #           #    #    #     #
# ######## # ######## # ######## # ######## #
#                                           #
#############################################